11111111111111111111111111111111111111111111
1000000C00C0C0C0C0C0C0C0C0000001111111111111
10000000C00000011111111111111111111111111111
10010111110000000000000000000000000000001111
10010000C0000P011110000000000000000000000011
1001000000000E0111100000000C00C0C00C00C00C01
10001111101100000C10C0C0C0C0CC0C0C00C0C0C0C1
10000000000000000111111000001111000011100001
10000000000000000100000100000C00C0C0C0C0C0C1
11111111111111111111111111111111111111111111